131111111111111111111111111111111111111111111111111111111111111111111111111111111111111111111111111111111111111111111111111111111
151225551222222555122222221222221212222222222222221222222222221222255512255555122555121222222222222222221225551222222212221222221
151215151111111515121112121112121212111111111112121211111111121211151511151115121515121211111111121211111215151211121212121112121
151215155515555515122212122222121212222212222212121212222212221212151555155515121515121212122222121212221215151212121212122212121
151215111515111115111212111111121211121112111212121212111211111212151115121515111515121212121112121212121215151212121212111212121
151215122555155555121212222212222212121222121212121212221222221212151555121515155515122222122212221212121215151222121222121212121
151215111111151111121211111211111212121211121212121211121111121212151511111515151115121111121211111112121215151111121111121212121
151215551222151212222212221212221222121212222222122212221222122222151515551515155515121222121212222222122215155555122212122212121
151112151212151212111112121212121211121211111211111212111112111111151515151515121515121212121212111111111115111115121212121112121
155512151212151222221222121222121212221212221212221212122222155555551515155515121515121212121212221222155555122215121212221222121
111512151112151111121212111111121112111212121112121112121112151111111515111115111515111212111211121112151111121215111212111211121
155512155512255512222212155555121222121222121222122222121212155512221515551215155515122212222212122212155512221215122212122222121
151112111511111511111111151115121211121111121211111111121212111512111511151215151115121111111212111212111511111215121112111112121
151222121515551555555555551555121212122222122212221222221222155512221515551555151215121222122222122212221555551225122212222222121
151112121515151111111111111511121212121212111112121211111112151112121515111511151215121212111211121112111111151115121211111111121
155512221555155512222222121512122212221212122222121222155512155512122555121555551555121212221212221222155555155515121222122222121
111511121111111512111212121512121111111212111112121112151511121511111111121111111511121211121112111212151115111515111212121111121
155512221222221512122212221512222222122212222222122222151555121515555512222222221512221212221222122212151215555515551212122222121
151111121211121511121111121512111112121111111111111112151115121515111512111211121512121212111211121211151211111111151112111112121
155555121222121555121222121512155512121212221222222212155515121515155512121222121512122212221222121215551222221222155512122212121
111115121212111115121212121512151512121212121211121112111515111515151112121112111511121111121112121215111211121112111512121212121
155515121212155515121212121512151512121222122222122222155515551515151222122212221555122212222212121215122222122222155512221212121
151515121112151515121211121511151512121211111111111111151111151515151211111211121115111112111212121115111112111112151112111212121
151515122222151555121222221515551512221215551555155555155515551515151212221222121555155512221212122215122212122212151222221212121
151515111112151111121111121515111511111215151515151115121515111515151212121212121511151511121112111215121212121212151111111212121
151555122222155555155555121555121512222215155515551215121515551555151222121212121555551555122222221215121222121222151222122212221
151111111111111115151115121111121512111115111111111215111511151112151111121211121111111115111111121215121112111112151212121112111
151555155515555555151215122222221512122215155512255555155512155512155555121222121222222215555555121215122212155512151212121222121
151515151515111111151215121111111512111215151511151111151112111512111115121112121212111111111115121215121211151511151212121211121
151515551555155555151215121555155512122215551555151225551222155512155515122212121212222222222215122215121215551515551212221222221
151511111111151115151215111515151112121211111115151115111112151111151515111212121211111111111215111215111215111515111211111211111
151512222222155515155515551515551222221222222215151555122222151225551515121212121212221222122215122215551555121515551212221212221
151512111211111515111511151511111211111111111115151511111212151215111515121212121212111212121115111112151511121511151212121112121
151512122215555515155512151512122212155555155555151512222212151215551555122222122212122212122215555512151555121555551212122222121
151512121215111115151112151512121112151115151111151512111111151211151111121111111212121112111211111512151115121111111212111111121
151512121215155515551222151512221222151555151222155515551555151222155512222212221212121222122212221512151555122222221222155515551
151512121115151511111212151511121211151511151212111115151515151111111512111112121212121211121212111512151511111211121211151515151
151512122215151512122212151555121215551512251212222215151515551555155512122212121212121222121212155512151515551212221215551555151
151512111215151512121112151115121215111511151111121115151511111515151111121212121212121112121212151111151515151212111215111111151
151512221215151512121222151555122215121555155555121555155515551515151222221222121222122212221212155555551555151212222215555512151
151512111215151512121212151511111115121115121115121511111115151515151211111111121111111211111212111111111111151111111211111512151
155512122215551512121212151515555555121555122215122555122225155515551222122222221222222212221212155555551555151555551215551512151
111112121111111512121211151515111111121511111215111115111115111111111112121111111211111112121212151111151515151511151215151512151
122212121555155512221222155515122215555515551215551225555555122222222212122212222212222222121212155512151515151512151215155512151
121211121515151112111112111115121215111115151111151111111111121211111212111212121111121211111212111512151515151512151215111112151
121212221515151222221555555515121215155515151555155555121222221222221222121212121222121212222222155512155515155512151215122222151
121212121515151211111511111515121115151515151515111215121211111111121111121212121212121112111111151112111115111112151115121111151
121222121515551215551512155515122215151555155515551215121212222222121222221212122212121222122215551225551215552222155555155555151
121111121511111215151512151115111215151111111111151215121212121111121212111212111112121211111215111115151211151112111111151115151
121222121515551215151512151225551215155555551215551215122222121222221212221212221222122212221215155515155512155512221215551215551
121212121515151115151512151211151215121111151215111215111111121212111112121211111211121112121215151515111512111511121215111211111
121212121555151555151512251215551555121555151555122215551222121212155512121212222212121222122215551515155512221512222215551555121
121212111111151511151511151115111511111515151511121111151212111212151512121212111112121211111111111515151111121511111111151515121
121212155555551555151555155515155515551515551555121555551212222212151512122222155512121222221555551515151555121515555522155515551
121212151111111215151115111515151115151511111115111511111211111112151511121111151512121211121511151515151515121515111512111111151
121212151555122215151555121555151555155515555515155512222222221212151555121555551512221212221515551555155515551515551512221222151
121212151515111115151511121111151511111215111515151111121111121212151115121511111512111112121515111111111111151511151511121212151
121212155515555515151512221222151512222215155515551555121222221222151555121512221512122212121515555522221222151555551512221212151
121212111111111515151512121211151511111215151111111515121211111211151511111512121512121212111511111511121212151111111512111212151
121212222222121515155512122215551555551215155555555515121222121222151515555512121512221222155512221512222212155512221512221212151
121211121112121515111112121115111211151215111111111115121112121112151515111112121511121111151111121511111112111512121511121212151
122222122212121515122212121555121222151215122212221555121212122222151515122222121555121555551555121555155512155512121555122212151
121111111212121515121212121511121112151115121212121511121212111111151515121111121115111511111515121115151512151112111115121111151
121212221212221555121212121512221222151555121222121555122212221555551555121222222215155512122515155515551512151222222215121555551
121212121211121111121212121512111211151511111111121115111211121511111111121211111115151112121515151511111511151211121215111511111
121212121212122212221222121512122212151512221222122215551212121515551222221212221555151222221515151555121555151222121215551512221
121212121212111212111111111512121112151512121212121211151212121515151212111212121511151111111515151115121115151211121111151511121
121212122212221212155555551512222222151512122212121215551222121515151212221222121515551555551515151215122215551212221222155512221
121212111112121212151111151511111112151512111112121215111111121515151112121112111515111511151515151215111211111212111212111112111
121212221222121222151222151515555512151512221212121215551555121515155512122212155515121555155515151225551212222212222212222222221
121211121212121112151212151515111511151511121212121111151515121515111511111212151115121215111115151111151212111112111111111111121
121222121212122212151212155515155515551512221222221555155515121515551515551212155555122215551215155555151222155512121555551555121
121211121212111212151212111115151115111512121111111515121115121511151515151211111111111112151215121115151111151512121511151515121
121212221212221212151212255515151215551512121555555515121555122555151555151222255555555512151215122215155515551512221512151515551
121212111211121212151111151515151212151512121511111115121511111115151111151111151111111511151215121115111515111511111512151511151
122212221212221212155515551515151222155522121555551555121555551555155512151555151215555515551555121555121555155515555512155512151
111211121212111212111515111515151112111111121111151511111211151511111512151515151215111115111511121511121111151115111112111112151
122222121212121212155515122515155512221555122215551515551212151515555512155515151555155515155512221512221222151225551555155515551
111111121112121212151115111515111511111515111115111515151212151515111112111115151511151515151111111512121112151111151515151515111
122222221222122212155515551515151555155515551555155515151222151555155515555515151555151515151555155512122222155555551515551555121
121111111211121112111511151515151115151111151511151115151111151111151515111515151115151515151515151112111112111111111511111111121
121222222212121222121515551555155515551222151555155515151555551215551555155515151215551555155515551222155512122222155515551222221
121112121112121211121515111111111511111112151115111515151511111215111111151115151212111111111111111211151512121111151115151111121
122212122212121222221515155555551555222222151555121515151512221555155512155555151222155512222222155515551512121555551555155555551
121212111212121111121515151111151115111112151511121515151512121511151512111111151111151511111211151515111512121511111511111111151
121212122212221222121515551222155515555512155512221555155512121515551555155512251555151515551222151555155512221515555515551555151
121212121112111212121512111211111512111512111111121111111112111515111115151512151515151515151212151111151111121515111115151515151
121212121222121212121512222215551512155512221555222222221215551515121555151512151515151555151215551222155512121515555515155515151
121211121211121212121511111215151511151111121515111111121215151515121511151512151515151111151115111212111512121511121515111115151
121222121212221212221555551215155515551555121515555555121215155515121555551512151515551555155515122212221512221555121515155515551
111112121211121211111111151215111115121515111511111115121215111115121111111512151511111515111515121211121511111115121515151511111
122222121212221215551555151215555515121515155512222215122215122555122212155512151555155515555515121222121555155555121515151555121
121111121212121215151515151211111515111515151112111115121115111511121212151112151115151211111115121112111115151111111515151115121
122212221212121215155515551215551515555515551222222215121555155512221222151222155515151215551215122212255515551555551515151215551
111212111212121215111111111215151515111111111112111215111511151111121211151111121515151115151215111211151511111511151515151211151
122212122222121215551555122215151515551555555512122215555515551222121215551555121555155555151215122212151555551512155515151215551
121112111112111211151515111115151511151511111512121111111115111212121215111515111112111111151215111212151111151512111115151215111
122212122212122215551515555515155515551555551512122225551555122212221215155515155512155555551215551212155515551512222215151215121
121212121212121115111511111515111115111111151512111115151511121112111115151115151512151111111211151212111515111512121215151215121
121212221212121215551512155515122215122555551512155555155512222212122215551215151512151222155515551222221515555512121215151555121
121212111211121211151512151115111215111511111511151111111112111211121211111215151511151212151515111211111511111112121115151511121
121212221212222222155512151225551225555512155515551222222212221222221222121555151555551212151515121215555512222222122555151512221
121211121212111111111112151211151112111112151115111112111211111112111212121511151111111211151515121215111211111211111511151512121
121222121222221555221555151222155512155515551555122212122212222212221212221512251555551555151555122215551215551215551555551512121
111112121111121515121515151112111511151515111511121212121112111211121211111512151511151515151111111112151115151215151111111512121
122222121555121515121515151222121555551515155512221222121222121212221215551512151515551515151212255512151555151215155515555512121
121112111515111515121515151211121111111515151112111111121112121212111215151512151515111515151212151512151511151215111515111112111
122212155515555515121515151222222222221515151222122222122222121212122215151512151515155515151212151512155515551215121515555512221
111211151111111115111515151211111111121515151211111211111111121212121215151511151515151115151212151511111215111215121511111511121
122215551222222215155515551215555555121515551212222212222222122212121215151555151515151215551222151555551215122215121555551555121
121115111211111215151111111115111115121511111212121112111112121111121115151115151515151211111111151111151115111115121111151115121
121555122212221215551555155555155515121512222212121222122212221222122215151555151515155515555515551555155515155555122212151225121
121511121112121111111515151111151515121511121112111211111211111212121215151511151515111515111515111515111515151111121212151115121
155512221222122222122515151555151555121555121222122212221222222212121215151555151515551515551515155515221515151222221222155515551
151112121211111112121515151515151111111215121211121112121112121112121215151115151511151511151515151115111515151112121111121511151
155512122222222212121515151515551555551215121222222212122212121212121215151555155522151555151515151215551515155512121555121512151
111512111111111212121515151511111511151115121111111212111211121212111215151511111112151115151515151211151515111512121515111512151
121512121555122212221515551555122555155515121222221222122222221222221215155512255512151555151515155555155515155512121515155515551
121512121515111111111511111115111115111515121211121211111211111111121215111111151511151511151515111115111115151112121515151115111
155512221515555515551512222225155555121515121212121212221212222222122215155515551555151555551515122215551225552222121515551555121
151111111511111515151512111115151111121515121212121112121112111112111115151515111115151111111515121211151211111111121511111511121
155555551555121555151512155515151222155515122222121222122222122212122215151515122215155515551515121215551215551222121512255515551
111111151215121111151511151515151212151115111112121211111111121212121215151515121215121515151515111215111115151211121511151115151
121555151215155555551555551515151215551225555512122212222222221212221215151515121215121555151515122215122555151222121555155555151
121515151115151111111111111515151115111111111512111111111112111211111215151515121115111112151515121115111511151212121115111111151
121515551555151225551555551515155515155555551512122222221222122212221215151515122215155512151515122215551512151212221555121222151
121511111511151115151511151515111515151111151512111112121211121112121215151515121215151511151515121211151512151111111511121212151
122555555512255555155512255515555515551222255512222222122212222222121225551555121225551555551555121222255512255555555512222212254
111111111111111111111111111111111111111111111111111111111111111111111111111111111111111111111111111111111111111111111111111111111
---
length=4134
time=11236