4 97 93
131111111111111111111111111111111111111111111111111111111111111111111111111111111111111111111
121222221222222222122222122222122222222222221222222212222212221222221222122222122222122212221
121112121212111112121112121212121111111111121212111211121212121211121212121211121112121212121
122212122212222212121212121212221222222222121212221222121222121212221212221222121212221222121
111212111111111212121212111211111211111112121211121112121111121212111211111112121211111112121
121212222222221212221212221212221222222212121222121212121222221212122212222212221222122212121
121212111111121211111211121212121211111211121111121212121112111212121112111211111212121212121
121212122222121222122222121212122212221222122212221212122212122212121222221212221212121212121
121211121112121112111212121212111112121112111212111212111212121111121112121212121211121212121
122212221212122212221212222212122212122212122212221212122212121222122212121222121222121212121
121112111212111211121111111112121211111212121111121212121112121212111211121111121112121212121
121222221222221212122222122222121222221212121222121222121212121212221212221222221222121212121
121112121111121212111112111211121111121212121212121211121212121211121212121111121211121211121
122212122212221222222212221222122212122212121212221222121212121212121222121222122212221212221
111211111211121111111211121112111212111212121211111112121212121212121112111212111112111212121
122212221222122212221222122212122212122212221212222212121222122212121222122212222212121212121
121112121112111212121112111212121112121111111212111212121211121112121211121111111212121212111
121222122212221212122212121212221212221222221212221212221222122222122212121222122212121212221
121112111211121212111112121211111212111212121212121111111112111112111112121112121112121212121
122212221222221212122222221212222212221212121212122222222212122212222222121222121622122212121
111212121111111212121111111212121111121112121211111112111212121211121111121211121112121112121
121212121222122212122212222212122222121222121222122222122212121212221222221222221222121222121
121212121211121112111212111111111211121211121112121111121112121211111211111211111211121111121
121212121222122212222212122222222212221222122212121222121222121222122212221212222212122222121
121212121112111211121112111211111212111212111212121212121211121112121112111212121112111112121
121212121222221222121212122212222212221212122212121212121212221212221222122212121222222212121
121211121211121112121212121211111111121212121112121212111211121211111212121111121112111212121
121222221222122212122212121212222222121212122222121212122212221222122212121222122212221212121
121111111112111212111112121112111112121212111111121212121112111212121212121212111211121212121
122212222212221212122222121222122212221212122222221212121222221212121212121212221212221212221
121211121211121212121111121211111211111112121111121212121211121211121211121211121212111211121
121222221222121212122212221222221222122222121222121212221212221222121222121222122212121212121
121111111112121112121212121111121212111211111212121211111112111112121112121212111112121212121
121222221222221222121212122222121212221222222212121212222212122212222212221212222212122222121
121211121211111211111211111112121211121112111112121212111212121211111211111211111212111112121
121222121222122212221212221222122212122212222212122212121212121212221222121222122212221222121
121111121211121112121212121211111112111211121112121112121212121212121112121112121111121211121
122222121212221222121212122212221222221222121222122222122212221222121222122222121222121222121
111112121212111211121212111112121211121112111211111111121112111111121211121111121212121112121
122212121212122212221212221222122212221212221222221222122212122212221212221222221212121222121
121212121212121112111211121211111112121211121211121212111211121212111212111211121212121112121
121222121212122212122222122212221222122212221212221212222212221222122212121222121212122212121
121111121212111212111112121112111211111212111112111211111112111111121112121112111212111211121
122212122212122212222222122212122212122212122212122212221212221222121222122212122212221212221
121212121112121111111111111212121112121112121212121112121212121212121211121212121111121212111
121212121212121222222222122222121212221212121222122222121222122212121222221212122212121222221
111212121212121111111212121111121212111212121111111111121211111112121111111212111212121111121
122212222212122212221212221212221222222212121222122222221222122222122212221212122212122222121
121112111112121212121112111212111111111212121212111111121111121111111212121212121112111112121
121222122222121212122212122212222212221212122212221222121222221222122222121212221222222212121
121111121111121212111212111211111212121112111112121212121211111212111111121111121211111212111
122222221222121222122212221222121222121222122212122212121222222212221222221222122212221212221
121111111212121111121111121212121111121211121211111112121211111111121211111212111212121112121
121222122212221222122222122212122212221212221212222222121222122212121222221212221212122212121
121212121111111112111112111112121212111212111212111111121112121212121111121211121212111212121
121212122212221222122222121222121212122212122212121222122212221212122212221212221212221212121
121112111212121211121111121211121112121112121112121212111211111212111211121212111211121211121
122212122212121222121222122212222212221222121222121212122212221222121222121212122222121222221
111212121112121112121211121111111211111211121211121212121112121112121112121212111112121111121
122212222222122222121222221222221222222212121222121212221222122212121222121212222212122212221
121111111112111112121211111211121211111112121112121211111112111112121211121211111211111212111
121222221212122212121212221222121222122222122222121222122212222222121222122212221222122212221
121211121212121211121212121212121212121112111111121112121211111112121112111112121112121111121
121222121222121212221212121212121212122212122222122222121222122212221212221222121222122212121
121112121211121212111212121112121112111212121211121111121112121211121211121112121211121212121
122222121222121222121222122222122212221212121212221222221222221222122222122212121222121212221
111111121112121111121111111111111212121212111212111211111111111112111112111212121112111211121
121222121222122212222212222212221212121212222212221212222212222222121222221212122212221222121
121212121111111212111212111211121211121211121111121212111212111111121211111212111111121212121
122212122222221212122222121212221222121222121222121212121212122222121212222212122222121212121
111112111111121212111111121212121112121112111212121212121212121212121212111112121212121112121
122212221212221212122222122212121222122212122212221212221212121212122212122212221212122212121
121212121212111212121112121112111211111212121111111211121212111212111112121212111211111212121
121222121212122212122212122212122212221212121222222222121212222212222222121222121222222212121
121111121212121112111212111212121112121212121211111211121211111111111111121111121111111112111
121212221212121222222212121212121222122212221212221212221212122222122222122212222212222212221
121212111212121211111112121212121211121111121112121212111212121212121211111212111211121112121
121212122212121212122212121212121212121222122222121212121212121212121222221212122222122222121
121212121212121212121212121212121212121212111111121212121212121211121112111212111112111112121
121222221212121212221212122222121212221212221222221212221212221212221212221212222212222212121
121111111212121212111212111211121211111211121112111211121211111212111211121212111211111211121
121222121212221216122212221212221222221222122212122222121222221222122222121212121212222222221
121212121211111211121111121212111211121112111212111212121111121112121112121212121211111111111
121212122212221222122212221212221212222212121212221212222222122212121212122212221222122222221
121212121112121112121212111111121112111212121211121112111111111212121212111111111112121111121
122212121222122222121212222222122212221212121222122212122222222212121212222222222212121212221
121112121211111111121211111211111212121112121112111211121111111112121211111211111212121212121
122212121212122222221222221222221212121222122212221222121222122222122212221222122212122212121
121112111212121111111111121111121212121211111211121112121212121111111112121112121112121112121
121222122212221222222222122222122212121222122212221222121212221222221222121222122212221222121
111212121111111211111112121112111112121112121212111211121211111211121211121211111212111211121
122212121222221212221222121222122212122222221212221222221212221222121222122212122212122212121
121111121211121212121211121211121211111112111111121111111212121112121112111112121111121112121
122212221222122212121212221212221212222212122222122212122212121222122222122222122212221222221
121212111112111112111212111212111212111211121112111212121112121211111111121211111212111211111
121222222222122222222222122222122222122222221222222212222222122212222222221222222222122222224
111111111111111111111111111111111111111111111111111111111111111111111111111111111111111111111
