131111111111111111111111111111111111111111111111111111111111111111111111111111111111111111111
151222221225555555155555122555155555555555551225555512255515551222221222122222122222122212221
151112121215111115151115121515151111111111151215111511151515151211121212121211121112121212121
155512122215555515151215121515551222222222151215551555151555151212221212221222121212221222121
111512111111111515151215111511111211111112151211151115151111151212111211111112121211111112121
121512222222221515551215551515551555555512151222151215151225551212122212222212221222122212121
121512111111121511111211151515151511111511151111151215151115111212121112111211111212121212121
121512155555121555122222151515155512221555155515551215155515122212121222221212221212121212121
121511151115121115111212151515111112121115111515111215111515121111121112121212121211121212121
155515551215122215551212255515155512122215155515551215155515121222122212121222121222121212121
151115111215111211151111111115151511111215151111151215151115121212111211121111121112121212121
151225551225551212155555122555151555551215151555151555151215121212221212221222221222121212121
151112151111151212111115111511151111151215151515151511151215121211121212121111121211121211121
155512155512251222222215551555155512155515151515551555151215121212121222121555122212221212221
111511111511151111111211151115111512111515151511111115151215121212121112111515111112111212121
155515551555155512221222155515155512155515551512222215151555122212121222155515555512121212121
151115151115111512121112111515151112151111111512111215151511121112121211151111111512121212111
151225155515551512122212121515551215551225551512221215551555122222122212151222155512121212221
151115111511151512111112121511111215111215151512121111111115111112111112151112151112121212121
155515551555551512122222221512222215551215151512122222222215155512222222151222151555122212121
111512151111111512121111111512121111151115151511111112111215151511121111151211151115121112121
121512151222155512122215555512122222151555151555122222122215151512221555551555551555121222121
121512151211151112111215111111111211151511151115121111121115151511111511111511111511121111121
121512151222155512222215122222222215551555155515121555121555151555155512221512255512122222121
121512151112111511121115111211111215111215111515121515121511151115151112111512151112111112121
121512151222221555121215122212222215551215155515121515121512251215551222155512151222222212121
121511151211121115121215121211111111151215151115121515111511151211111212151111151112111212121
121555551222122215122215121215555555151215155555121515155515551222155512151555155512221212121
121111111112111215111115121115111115151215111111121515151115111212151512151515111511121212121
122212222212221215155555121555122215551215122222221515151225551212151512151515551512221212221
121211121211121215151111121511111211111115121111121515151211151211151511151511151512111211121
121222221222121215155512221555551555122555121555121515551215551222151555151555155512121212121
121111111112121115121512121111151515111511111515121511111115111112151115151215111112121212121
121222221222221555121512122222151515551555555515121515555515155512255515551215555512122222121
121211121211111511111511111112151511151112111115121515111515151511111511111211111512111112121
121222121222155515551512221222155512155512222215155515121515151515551555121222155512221222121
121111121211151115151512121211111112111511121115151115121515151515151115121112151111121211121
122222121215551555151512122215551555551555121555155555155515551555151555122222151555121222121
111112121215111511151512111115151511151115111511111111151112111111151511121111151515121112121
122212121215155515551512221555155515551215551555551555155512155515551512221555551515121222121
121212121215151115111511121511111115121211151211151515111511151515111512111511121515121112121
121222121215155515122555155512221555122215551215551515555515551555155512121555121515122212121
121111121215111515111115151112111511111215111115111511111115111111151112121115111515111211121
122212122215155515555555155512155512122215155515155515551215551555151222122215155515551212221
121212121115151111111111111512151112121115151515151115151212151515151211121215151111151212111
121212121215151222222222155522151212221215151555155555151222155515151222221215155512151222221
111212121215151111111212151111151212111215151111111111151211111115151111111215111512151111121
122212222215155515551215551215551222222215151555122222251222155555155515551215155512155555121
121112111115121515151115111215111111111215151515111111151111151111111515151215151112111115121
121222155555121515155515122215555515551215155515551555151555551555122555151215551222222215121
121111151111121515111515111211111515151115111112151515151511111515111111151111121211111215111
155555551222121555155515551555121555151555155512155515151555555515551555551555122215551215551
151111111212121111151111151515121111151511151511111115151211111111151511111515111215151112151
151222122212221222155555155515122215551515551515555555151222122212151555551515551215155512151
151212121111111112111115111115121215111515111515111111151112121212151111151511151215111512151
151212122212221222155555121555121215155515155515121555155512221212155512251515551215551512151
151112111212121211151111121511121115151115151115121515111511111212111511151515111211151511151
155512122212121222151222155512222215551555151555121515155512221222121555151515122222151555551
111512121112121112151211151111111211111511151511121515151112121112121115151515111112151111121
155512222222122222151555551555551555555512151555121515551222122212121555151515555512155512221
151111111112111112151511111511151511111112151115121511111112111112121511151511111511111512111
151555551212155512151515551555151555122222155555121555155512222222121555155512221555155512221
151511151212151511151515151215151215121112111111121115151511111112121115111112121115151111121
151555151222151515551515151215151215122212122222155555151555155512221215551222121555155512121
151115151211151515111515151115151115111212121211151111151115151511121211151112121511121512121
155555151222151555121555155555155515551212121215551555551225551555122222155512121555121512221
111111151112151111121111111111111512151212111215111511111111111115111112111512121115111511121
121222151222155512222212222212221512151212222215551515555515555555121222221512122215551555121
121212151111111512111212111211121511151211121111151515111515111111121211111512111111151215121
122212155555551512122222121212221555151222121555151515121515122555121215555512155522151215121
111112111111151512111111121212121115151112111515151515121515121515121215111112151512151115121
122212221215551512155555122212121555155512155515551515551515121515122215155515551512155515121
121212121215111512151115121112111511111512151111111511151515111515111115151515111511111515121
121222121215155512155515122212155515551512151222222522151515555515555555151555121555555515121
121111121215151112111515111212151115151512151211111511151511111111111111151111121111111115111
121212221215151555555515121212151555155512251215551515551512122222155522155515555512222215551
121212111215151511111115121212151511121111151115151515111512121212151511111515111511121112151
121212122215151512155515121212151512121555155555151515121512121212151555221515122555122222151
121212121215151512151515121212151512121515111111151515121512121211151115111515111115111112151
121222221215151515551515122222151512221515551225551515551512221215551215551515555515555512151
121111111215151515111515111211151511111511151115111511151511111215111211151512111511111511151
121222121215551515155515551215551555551555155515122555151555551225122222151512121512222555551
121212121211111511151111151215111211151115111515111215151111151115121112151512121511111111111
121212122215551555155515551215551215552215121515551215552222155515121212155512221555155555551
121212121115151115121515111111151115111215121511151112111111111515121212111111111115151111151
122212121555155555121515555522155515551215121555155512155555555515121212222555555515151215551
121112121511111111121511111511111512151115121115111511151111111115121211111511111515151215151
122212121512122222221555551555551512151555122215551555151555155555122215551555155515152215151
121112111512121111111111151111151512151511111211151115151515151111111115151115151115151115151
121222155512221555555555155555155512151555122215551555151515551555551555151555155515551555151
111212151111111511111115151115111112151115121215111511151511111511151511151511111512111511151
122212151555551512221555151555155512155555221215551555551515551555151555155512155512155512151
121111151511151512121511151511151511111112111111151111111515151115151115111112151111151112151
122215551555155512121515551515551515555512155555155512155515151555155555122222155515551555551
121215111115111112111515111515111515111511151115111512151115151511111111121211111515111511111
121225555555122222222555122555122555122555551225555512255555155512222222221222222555122555554
111111111111111111111111111111111111111111111111111111111111111111111111111111111111111111111
---
length=2838
time=6633