113111111111
155552222221
151151111121
151551555121
151515515121
151515115111
151115515121
151211515121
155555515551
111111111151
125555555551
114111111111
---
length=55
time=77