2 33 59
13111111111111111111111111111111111111111111111111111111111
12122222122212222222222212122222221222122222222212222212221
12121112121211111211111212121111121212121211111212111212121
12221212121212221222221212221222221212121222121212221212121
11111212121212121211121211111211111212121112121212121211121
12122212121222121212121222221212221212121222121212121222121
12121212121111121212121111121212121212121211121211121112121
12121222121212221212121222221222122212221222121222122212121
12121111121212111212121112111211111111121112121112121212121
12121222121212221212122212122212221222121222122222121212221
12121212121211121212111212111112121212111211121111121211121
12221212121222121212221212122222122212222212121222221222121
12111212121212121212111212121111111111111112121111111112111
12221212121212221222122212121622122222122222121222222212221
11121212121211111211121112121112121211121212121211111212121
12221212121212222212221222122212121212221212121212222212121
12111212121212111112111211111212121212111212121211121112121
12221212221212122222121212222212221222121212121222122212121
11121211111211121111121212121211111211121211121112111211121
12121222221222221212222212121212221222221222122212221222221
12121211121111111212111111121212121211111112111211121111121
12121222122612222212221222221212121212222212221222122212221
12121112111212111211121112111112121212111212111112121212111
12221222122212221222121222122222121212122222122212121212221
12111111121112121111121211121111121112121111121212121211121
12122222121222121222121212221222122212121222121222121212121
12111212121211121212121212111112111212121212121111111212121
12122212221212121212221212221222122212121212221222222212121
12121111111212121211111211121212121112111211111211111112121
12221222122212121222122222222212121222122212222212222222121
11111212121112121112111111111111121212121112111112111111121
12222212222222122222222222222222221212222222122222222222221
11111111111111111111111111111111111111111111111111111111141
